%%%%%%%%%%%%%%%%%%%%%%%%%%%%
%%%%%%       o         %%%%%
%%%%%%%%%%%%%%%%%%%%%  %%%%%
%.  %%                     %
% %%%% %%%%%.%%.%%%%%.%%%% %
%.%%%% %%%%%.%%.%%%%%.%%%% %
%                          %
%%%.%% %% %%%%%%%% %% %%.%%%
%%%.%%.%%.%%%%%%%%.%%.%%.%%%
%      %%    %%    %%      %
% %%%%%%%%%%.%%.%%%%%%%%%%.%
%.            P            %
%%%%%%%%%%%%%%%%%%%%%%%%%%%%
