%%%%%%%%%%%%%%%%%%%%%%%%%%%%
%%%%%%.                %%%%%
%%%%%%%%%%%%%%%%%%%%%  %%%%%
%.  %%                   . %
% %%%% %%%%%.%% %%%%% %%%% %
% %%%% %%%%% %%.%%%%% %%%% %
%                         .%
%%%.%% %% %%%%%%%% %% %% %%%
%%% %% %%.%%%%%%%% %% %% %%%
%      %%    %%    %%      %
% %%%%%%%%%% %% %%%%%%%%%% %
%.            P           .%
%%%%%%%%%%%%%%%%%%%%%%%%%%%%
