%%%%%%%%%%%%%%%%%%%%%%%%%%%%
%%%%%%%             % %%%%%%
%%%%%%% %%%%%%%%%% %. %%%%%%
%.  %%                     %
% %%%%.%%%%%.%%.%%%%%.%%%% %
%.%%%%.%%%%%.%%.%%%%%.%%%% %
%o  %                 %%  o%
%%% %%.%% %%%%%%%% %  %%. %%
%%%.%%.%% %%%%%%%%.%%.%%.%%%
%      %%    %%    %%      %
% %%%%%%%%%%.%%.%%%%%%%%%%.%
%.            P            %
%%%%%%%%%%%%%%%%%%%%%%%%%%%%
